WWWWWWWWWW
WTW    D W
W W  WWWWW
W        W
W WWWWWW W
W    WWW W
WWWW WWW W
W        W
W WWWWWWWW
W WU     W
W    WWWWW
WWWWWWWWWW

M 12 10
U 10 4 EAST
D 2 9 WEST
T 2 2